{
    "levels": {
        "level_1": {
            "level_grid": [
                [1, 1, 1, 1, 1, 1, 1, 1, 1, 1],
                [1, 0, 0, 0, 0, 0, 0, 0, 0, 1],
                [2, 0, 0, 0, 0, 0, 0, 0, 0, 3],
                [1, 0, 0, 0, 0, 0, 0, 0, 0, 1],
                [1, 1, 1, 1, 1, 1, 1, 1, 1, 1]
            ],
            "entrance": [0, 2],
            "exit": [9, 2],
            "chests": []
        },
        "level_2": {
            "level_grid": [
                [1, 1, 1, 1, 1, 1, 1, 1, 1, 1],
                [1, 0, 0, 0, 0, 0, 0, 0, 0, 1],
                [2, 0, 0, 0, 0, 0, 0, 0, 0, 3],
                [1, 0, 0, 0, 0, 0, 4, 0, 0, 1],
                [1, 1, 1, 1, 1, 1, 1, 1, 1, 1]
            ],
            "entrance": [0, 2],
            "exit": [9, 2],
            "chests": [
                {
                    "position": [6, 3],
                    "contents": ["sword", "bandage", "torch"],
                    "direction": "up"
                }
            ]
        },
        "level_3": {
            "level_grid": [
                [1, 1, 1, 1, 1, 1, 1, 1, 1, 1],
                [1, 0, 0, 0, 0, 0, 0, 0, 0, 1],
                [2, 0, 1, 1, 0, 0, 0, 0, 0, 3],
                [1, 0, 0, 0, 0, 1, 0, 0, 0, 1],
                [1, 1, 1, 1, 1, 1, 1, 1, 1, 1]
            ],
            "entrance": [0, 2],
            "exit": [9, 2],
            "chests": []
        }
    }
}
